16 16
0000000100000000
0111100000000000
0000100000011110
00S0100000010110
0000100110011100
0000100010010110
0011100010010010
0010000010000000
0000100011101000
0000100000001000
000110111011111E
0011000100001000
0010010101100011
0000010101010101
0000110001001001
0001100001000001